*,*,*,*,*,*,*,*,*,*,*,*,*,
,*, , ,*,*, , , , , , , ,1,
,*, , , , , ,*,*,*,*,*,*,*,
,*, , , , , , , , ,*,*,*,*,
,*,*, , , , , , , , , , ,*,
,*, , , , , ,*,*,*,*, ,*,*,
,*,*,*,*,*,*,*,*,*,*, ,*,*,
,*, , , , , , , , , , , ,*,
,*, , , , ,*,*,*,*,*,*,*,*,
,*, , , , , , , , ,*, , ,*,
,*,*,*,*,*,*,*,*, , , , ,*,
,*,*,*,*,*,*,*,*,*,2,*,*,*